##########
#        #
#  ##    #
#     ## #
#        #
##########
